+---+---+---+---+---+---+---+---+---+---+---+---+---+---+---+
|   |               |       |       |       |       |       |
+   +---+---+   +   +   +   +   +   +   +   +   +   +   +   +
|           |   |       |       |       |       |       |   |
+---+---+   +   +---+---+---+---+---+---+---+---+---+---+   +
|       |   |   |       |           |       |           |   |
+   +   +   +   +   +   +   +---+   +---+   +   +   +   +   +
|   |       |       |           |       |       |   |   |   |
+   +---+---+---+---+---+---+---+---+   +---+   +   +---+   +
|   |     D     |       |           |     P |   |   |     E |
+   +   +   +   +   +   +   +---+   +---+   +---+   +   +---+
|   |   |   |       |       |   |           |       |       |
+   +---+   +---+---+---+---+   +---+---+---+   +   +---+   +
|       |   |       |       |       |           |       |   |
+---+   +   +   +   +   +   +   +   +   +---+---+---+---+   +
|   |   |       |   |   |       |       |                   |
+   +   +---+---+   +   +---+---+   +---+   +---+---+---+---+
|       |           |   |           |       |           |   |
+   +---+   +---+---+   +---+---+---+   +---+---+   +   +   +
|           |   |       |               |           |       |
+---+---+---+   +   +   +   +---+---+---+   +---+---+---+   +
|               |   |   |   |       |       |       |   |   |
+   +---+---+   +   +   +   +   +   +---+   +   +   +   +   +
|   |       |   |   |   |       |       |   |   |       |   |
+   +   +   +   +   +   +---+---+---+   +   +   +---+   +   +
|       |   |       |               |       |   |       |   |
+---+---+   +---+---+---+---+---+   +---+---+   +   +---+   +
|       |   |               |       |           |   |       |
+   +   +   +---+   +---+   +   +---+   +   +---+---+   +---+
|   |               |       |           |                   |
+---+---+---+---+---+---+---+---+---+---+---+---+---+---+---+